111111111111111111111111111111
1000000P00000000C0000000E00001
111111111111111111111111111111