111111111111111111111111111111111111111
1P10000000000000000000000000000000C0001
100000000000000000000000000000000000001
1000000000000000000C0000000000000000001
100000000000000000000000000000000000001
1000C00000000000000000000000000001E1001
100000000000000000000000000000000010001
111111111111111111111111111111111111111