111111111111111111111111111111
1000000000000000C0000000E00001
1000000000000P0000000000000001
100000000000000000000000000001
111111111111111111111111111111