111111111111111111111111111111111111111
100000000000000000000000000000000000001
100011100000000000000000000E00000000001
100010C10000000000000000000000000000001
1000111000000000P0000000000000000000001
100000000000000000000000000000000000001
111111111111111111111111111111111111111