111111111111111111111111111111111111111
100000000000000000000000000000000000001
100000000C00000000010000000000000000001
1000000000000000001E1110000000000000001
1000000000000000P0011010000000000000001
100000000000000000011111000000000000001
111111111111111111111111111111111111111