111111111111111111111111111111111111111
100000000000000000000000000000000000001
1000000000000000000C0000000000000000001
101000000000000000000000000000000000001
1000000000000000P0000000000000000000001
1000C0000000000000000000000000000000001
111111111111111111111111111111111111111