1111111111
10C000P0E1
1111111111